##            ##
#              #
                
    11111111    
    12222221    
    12333321    
    12355321    
    12355321    
    12333321    
    12222221    
    11111111    
                
                
                
#              #
##            ##