################
##            ##
#              #
#22222222222222#
#              #
#   OOOOOOOO   #
#   OO3OO3OO   #
#   OOOOOOOO   #
#    1#11#1    #
#    1 ## 1    #
#              #
##            ##
###          ###
##            ##
#              #
                